1----------------------------2
|._._._._._._._._._._._._._._|
|_._._._._._._._._._._._._._.|
|._._._._._._._._._._._._._._|
|_._._._._._._._._._._._._._.|
|._._._._._._._._._._._._._._|
|_._._._._._._._._._._._._._.|
|._._._._._._._._._._._._._._|
|_._._._._._._._._._._._._._.|
|._._._._._._._._._._._._._._|
|_._._._._._._._._._._._._._.|
|._._._._._._._._._._._._._._|
|_._._._._._._._._._._._._._.|
|._._._._._._._._._._._._._._|
|_._._._._._._._._._._._._._.|
|._._._._._._._._._._._._._._|
|_._._._._._._._._._._._._._.|
|._._._._._._._._._._._._._._|
|_._._._._._._._._._._._._._.|
|._._._._._._._._._._._._._._|
|_._._._._._._._._._._._._._.|
|._._._._._._._._._._._._._._|
|_._._._._._._._._._._._._._.|
|._._._._._._._._._._._._._._|
|_._._._._._._._._._._._._._.|
|._._._._._._._._._._._._._._|
|_._._._._._._._._._._._._._.|
|._._._._._._._._._._._._._._|
|_._._._._._._._._._._._._._.|
3----------------------------4