5-------------------6
|;;;;;;;;;|;;;;;;;;;|
|;5-6;5-6;|;5-6;5-6;|
|;| |;| |;|;| |;| |;|
|;7-8;7-8;|;7-8;7-8;|
|;;;;;;;;;;;;;;;;;;;|
|;5-6;|;5---6;|;5-6;|
|;7-8;|;7---8;|;7-8;|
|;;;;;|;;;|;;;|;;;;;|
7---6;|--   --|;5---8
    |;|       |;|    
    |;| 5---6 |;|    
----8;| |   | |;7----
     ;| |   | |;     
----6;| 7---8 |;5----
    |;|       |;|    
    |;| 5---6 |;|    
5---8;| 7---8 |;7---6
|;;;;;;;;;|;;;;;;;;;|
|;--6;---;|;---;5--;|
|;;;|;;;;; ;;;;;|;;;|
|-6;|;|;5---6;|;|;5-|
|-8;;;|;7___8;|;;;7-|
|;;;;;|;;;|;;;|;;;;;|
|;-------;|;-------;|
|;;;;;;;;;;;;;;;;;;;|
7-------------------8